11111111111111111111
10000000000C00000001
1010C111110000000111
1010011111C000100C01
1P0011E0000001100111
11111111111111111111
