111111111111111111111111
10C100000C00110001000C01
1000011111000C0001101111
1P0011E000001111000C0001
111111111111111111111111
