1111111111111111111111111111111111
1000000000000000000000C10000000001
1010011111000000000000000000000001
1010011111000000000000000000000001
1P0011E000000000000000000000000001
1111111111111111111111111111111111
